 ####
###@ #
#    #
# $$$###
##$.$  #
 #.....#
##$.   #
# $ ####
#   #
#####