   # # # # 
# # #     # # # # 
#     $ @       # 
#   #     # $   # 
#   .   . #     # 
# # # # # # # # #